11111111111111111111111
10000000000000010000001
10P00C000C0000000000C01
10000E0000000001M000001
10000000000000010000001
10000000000000010000001
11111111111111011111111
10000000000100000000001
10000C0000M000000C00001
10000000000000000000001
10000M0000M0000M0000001
100000000000000000M0001
100M0000000100000000001
11111111111111111111111
