11111111111111111111111
100P000000000000M00C0E1
11111111111111111111111
