1111111111111
1P00000000001
11000000M0001
1110000000001
11110000M0001
1111100000C01
11111100M0C01
11111110000E1
1111111111111