1111111111111
1P001001000E1
1000100100001
1C001001000C1
10001001M0001
1C001001000C1
1000M00000001
1C001001000C1
1111111111111