1111111111111
1P0010000M0C1
1000011111001
1000000C0E001
1111111111111