1111111111111
1P0000000C0E1
1000000M00001
1C000000000C1
1000011100001
1C00M0000C001
1111111111111