1111111111111111111
1P000000000000000E1
100000000M000000001
1C000000000000000C1
1111111111111111111